1111111111111111111111
1000010000100001111111
1011010110101101111111
1000010000100001111111
1011010011100111111111
1000010100101001111111
1111111111111111111111
1111111111111110111111
1110111010001010111011
1000C00C000000P0000CE1
1111111111111111111111
