11111111
1P000101
100C1E11
10000101
11111111
