11111111111111
1P00E001010001
10000000000001
10000000000001
10100C000W0001
10101C10001111
10000000000001
10100C000W0001
10101C10001111
11111111111111
