   111  111
   10111101
1111P000001
1010011101111111
1000011000000001
10001 1000111111
11111 11111