11111111
1E000101
100C1P11
10000101
11111111
